war	WAR
fight	WAR
field	WAR
hospital	WAR
battle	WAR
army	WAR
enemy	WAR
gun	WAR
cannon	WAR
shell	WAR
attack	WAR
shoot	WAR
kill	WAR
desperate	WAR
die	WAR
cavalry	WAR
squadron	WAR
soldier	WAR
marshal	WAR
colonel	WAR
general	WAR
peace	PEACE
love	PEACE
court	PEACE
palace	PEACE
home	PEACE
house	PEACE
child	PEACE
family	PEACE
friendship	PEACE
marriage	PEACE
wife	PEACE
husband	PEACE
happy	PEACE
joyful	PEACE
joy	PEACE
birthday	PEACE
holiday	PEACE
wedding	PEACE
dress	PEACE
dance	PEACE
ballroom	PEACE
ball	PEACE
quiet	PEACE
calm	PEACE